1111111111111111111111111111111
1000000000000000000000000000001
1000000000000000000000000000001
1000000000000011100000000000001
100000000000001X100000000000001
1000000000000011100000000000001
1000000000000000000000000000001
1P0000000000000C0000000000000E1
1000000000000000000000000000001
1000000000000000000000000000001
1000000000000000000000000000001
1000000000000000000000000000001
1000000000000000000000000000001
1000000000000000000000000000001
1111111111111111111111111111111
