11111111111111111111111
110C00000001111111111E1
1P000111000011111111001
11000000C000X1111110011
10011000011111111110011
10C00000000000000000111
11111111111111111111111