11111111111111111
1P00001C0000E1C01
1010C111000111101
100000000C0000001
10101111111111101
100001110C0X00001
111C0010001111111
11111111111111111
