111111111111111111111111111111111
10C0000111110C00000001111111111E1
10P000001110000111000011111111001
111101101100000000C00001111110011
111000000001111000011111111110011
11111C111000C00000000000000000111
111111111111111111111111111111111