11111111111111111
1PC0001C0000E1C01
1010C111000111101
100000111C0000001
10101111111111101
100001110C0000001
111C0000001111111
11111111111111111
