111111111111111
100000000000001
100000000000001
100000000000001
100000000000001
100000000000001
1000000X0000001
1P00000C00000E1
100000000000001
100000000000001
100000000000001
100000000000001
100000000000001
100000000000001
111111111111111
